QQQQQQQQQQQQQQQQQQQQ
Q##################Q
Q##^^^###^^^#######Q
Q##^^^#|#^^^##|##|#Q
Q##^^^###^^^###|###Q
Q##-----------#####Q
Q############-#####Q
Q######|------|####Q
Q######|------|####Q
Q##|###|------|####Q
Q##||###------#####Q
Q##|##|#-##########Q
Q#######-####^^^###Q
Q###||##-####^^^###Q
Q##||###-|###^^^###Q
Q##||###--------###Q
Q##################Q
Q###~~~############Q
Q##~~~~~###########Q
Q###~~~############Q
QQQQQQQQQQQQQQQQQQQQ
