~~~~~~~~~~~~~~~~~~~~~~~~~~~~~~~~~~~~~~~~~~~~~~~~~~~~~~~~~~~
~~~~~~~~~~~~~~~~~~~~~~~~~~~~~~~~~~~~~~~~~~~~~~~~~~~~~~~~~~~
~~~~~~~~~~~~~~~~~~~~~~~~~~~~~~~.......~~~~~~~~~~~~~~~~~~~~~
~~~~~~~~~~~~~~####~.~..~~~~~.....####......~~~~~~~~~~~~~~~~
~~~~~~~~~~~~~######^##........#~~~~######...~~~~~~~~~~~~~~~
~~~~~~~~~~#########^^^##.....#~~~~~~~####...~~~~~~~~~~~~~~~
~~~~~~~^^##########^^^#########~~~~####...~~~~~~~~~~~~~~~~~
~~~~~~~^^^######~##^^^^^###############.~~~~~~~~~~~~~~~~~~~
~~~~~~##^^^^###~~~##^^^^^^#########~~~~~~~~~~~~~~~~~~~~~~~~
~~~~~~###^^^##~~~~~###^^^^^###@########~~~~~~~~~~~~~~~~~~~~
~~~~~####^^^##~~~~~~###^^^^#############~#~~~~~~~~~~~~~~~~~
~~~~~#####^^^#~~~~~~~###^^^#######~########~~~~~~~~~~~~~~~~
~~~~~~~###^^^#~~~~~~~####^^^#####^~^###########~~~~~~~~~~~~
~~~~~#~~###^^#~~~~~~~##^^########^^^##########~#~~~~~~~~~~~
~~~~.###~##^^##~~~~~####^^######~^^^^^^#########~~~~~~~~~~~
~~~~.............~~#####^^^#####~^^~^^###########~~~~~~~~~~
~~~..............#~#####^^^^####^^^#####....########~~~~~~~
~~~.............#~~########^####^^^~~~...~~...###~~#~###~~~
~~~~........####~~###############~~~~~~~~~~~~.##~~~##~~##..
~~~~~......####~~#####~~~~~######~~~~~~~~~~~~~.#~~######.~~
~~~~~...~..####~~###~~~~~~~~~~~~~~~~~~~~~~~~~~~.~######..~~
~~~~..~~~....#####~~~~~~~~~~~~~~~~~~~~~~~~~~~~~.........~~~
~~~..~~~~~...###~~~~~~~~~~~~~~~~~~~~~~~~~~~~~~~~~~~.....~~~
~~~#~~~~~~~~~~~~~~~~~~~~~~~~~~~~~~~~~~~~~~~~~~~~~~~~~~.~~~~
~~~~~~~~~~~~~~~~~~~~~~~~~~~~~~~~~~~~~~~~~~~~~~~~~~~~~~~~~~~
