~~~~~~~~~~~~~~~~~~~~~~~~~~~~~~~~~~~~~~~~~~~~~~~~~~~~~~~~~~~
~~~~~~~~~~~~~~~~~~~~~~~~~~~~~~~~~~~~~~~~~~~~~~~~~~~~~~~~~~~
~~~~~~~~~~~~~~~~~~~~~~~~~~~~~~~#######~~~~~~~~~~~~~~~~~~~~~
~~~~~~~~~~~~~~####~#~##~~~~~###############~~~~~~~~~~~~~~~~
~~~~~~~~~~~~~######^###########~~~~#########~~~~~~~~~~~~~~~
~~~~~~~~~~#########^^^########~~~~~~~#######~~~~~~~~~~~~~~~
~~~~~~~^^##########^^^#########~~~~#######~~~~~~~~~~~~~~~~~
~~~~~~~^^^######~##^^^^^################~~~~~~~~~~~~~~~~~~~
~~~~~~##^^^^###~~~##^^^^^^#########~~~~~~~~~~~~~~~~~~~~~~~~
~~~~~~###^^^##~~~~~###^^^^^############~~~~~~~~~~~~~~~~~~~~
~~~~~####^^^##~~~~~~###^^^^#############~#~~~~~~~~~~~~~~~~~
~~~~~#####^^^#~~~~~~~###^^^#######~########~~~~~~~~~~~~~~~~
~~~~~~~###^^^#~~~~~~~####^^^#####^~^###########~~~~~~~~~~~~
~~~~~#~~###^^#~~~~~~~##^^########^^^##########~#~~~~~~~~~~~
~~~~####~##^^##~~~~~####^^######~^^^^^^#########~~~~~~~~~~~
~~~~#############~~#####^^^#####~^^~^^###########~~~~~~~~~~
~~~###############~#####^^^^####^^^#################~~~~~~~
~~~##############~~########^####^^^~~~###~~######~~#~###~~~
~~~~############~~###############~~~~~~~~~~~~###~~~##~~####
~~~~~##########~~#####~~~~~######~~~~~~~~~~~~~##~~#######~~
~~~~~###~######~~###~~~~~~~~~~~~~~~~~~~~~~~~~~~#~########~~
~~~~##~~~#########~~~~~~~~~~~~~~~~~~~~~~~~~~~~~#########~~~
~~~##~~~~~######~~~~~~~~~~~~~~~~~~~~~~~~~~~~~~~~~~~#####~~~
~~~#~~~~~~~~~~~~~~~~~~~~~~~~~~~~~~~~~~~~~~~~~~~~~~~~~~#~~~~
~~~~~~~~~~~~~~~~~~~~~~~~~~~~~~~~~~~~~~~~~~~~~~~~~~~~~~~~~~~
